# , S , . , . , #
# , . , . , . , #
# , . , P , . , #
# , . , . , . , #
# , . , . , . , #

